sample,groundtruthed_total,processed_total,groundtruthed_plant_total,groundtruthed_nonplant_total,processed_plant_total,processed_nonplant_total,ppgpint,pngnint,ppgnint,pngpint,punion,nunion,piou,niou
gp_10_06_24_2023,30,34340,16,14,8661,25679,12,14,0,6,18,20,0.6666666666666666,0.7
gp_10_08_02_2023,487,545587,347,140,329112,216475,317,136,4,30,351,170,0.9031339031339032,0.8
gp_10_08_12_2023,411,446777,348,63,340759,106018,329,53,10,20,359,83,0.9164345403899722,0.6385542168674698
gp_10_08_25_2023,323,332373,236,87,256605,75768,225,62,25,11,261,98,0.8620689655172413,0.6326530612244898
gp_10_09_07_2023,302,317786,215,87,205655,112131,201,78,9,16,226,103,0.8893805309734514,0.7572815533980582
gp_10_09_14_2023,286,305416,203,83,176441,128975,168,75,8,36,212,119,0.7924528301886793,0.6302521008403361
gp_11_06_24_2023,727,733043,269,458,156737,576306,150,450,9,143,302,602,0.4966887417218543,0.7475083056478405
gp_11_08_02_2023,586,615542,494,92,463421,152121,437,83,9,58,504,150,0.8670634920634921,0.5533333333333333
gp_11_08_12_2023,289,306916,219,70,228310,78606,210,57,13,9,232,79,0.9051724137931034,0.7215189873417721
gp_11_08_25_2023,278,303999,228,50,220988,83011,213,45,5,15,233,65,0.9141630901287554,0.6923076923076923
gp_11_09_07_2023,365,383339,262,103,264879,118460,254,97,6,8,268,111,0.9477611940298507,0.8738738738738738
gp_11_09_14_2023,335,349802,248,87,216130,133672,210,80,7,38,255,125,0.8235294117647058,0.64
gp_12_06_24_2023,93,111532,43,50,24205,87327,24,50,0,21,45,71,0.5333333333333333,0.704225352112676
gp_13_06_24_2023,616,641432,223,393,83305,558127,76,391,2,161,239,554,0.3179916317991632,0.7057761732851986
gp_13_08_02_2023,800,745974,697,103,678394,67580,672,75,27,25,724,127,0.9281767955801105,0.5905511811023622
gp_14_06_24_2023,211,214804,102,109,59682,155122,59,107,2,57,118,166,0.5,0.6445783132530121
gp_14_08_02_2023,575,601917,405,170,354992,246925,332,169,1,73,406,243,0.8177339901477833,0.6954732510288066
gp_15_06_24_2023,683,697079,227,456,108693,588386,126,455,4,154,284,613,0.44366197183098594,0.7422512234910277
gp_17_06_24_2023,257,260393,117,140,93895,166498,92,134,6,34,132,174,0.696969696969697,0.7701149425287356
gp_17_08_02_2023,173,183610,141,32,143375,40235,137,32,0,4,141,36,0.9716312056737588,0.8888888888888888
gp_18_06_24_2023,228,229663,108,120,95089,134574,93,120,0,27,120,147,0.775,0.8163265306122449
gp_18_07_07_2023,657,839604,478,179,437799,401805,455,179,0,39,494,218,0.9210526315789473,0.8211009174311926
gp_19_06_24_2023,248,250858,95,153,84886,165972,82,153,0,16,98,169,0.8367346938775511,0.9053254437869822
gp_19_08_02_2023,157,186711,135,22,139711,47000,133,21,1,2,136,24,0.9779411764705882,0.875
gp_19_08_12_2023,274,282414,241,33,230191,52223,235,28,5,6,246,39,0.9552845528455285,0.717948717948718
gp_19_08_25_2023,305,315084,282,23,273910,41174,274,20,3,8,285,31,0.9614035087719298,0.6451612903225806
gp_19_09_01_2023,307,318243,293,14,268699,49544,265,14,0,28,293,42,0.9044368600682594,0.3333333333333333
gp_20_06_24_2023,235,236699,95,140,82585,154114,77,139,2,23,102,164,0.7549019607843137,0.8475609756097561
gp_20_08_02_2023,251,257542,227,24,221787,35755,222,24,0,5,227,29,0.9779735682819384,0.8275862068965517
gp_20_08_12_2023,320,326012,283,37,265209,60803,265,34,3,18,286,55,0.9265734265734266,0.6181818181818182
gp_20_08_25_2023,270,279668,249,21,236208,43460,236,19,2,13,251,34,0.9402390438247012,0.5588235294117647
gp_20_09_07_2023,330,349959,308,22,282326,67633,288,20,2,20,310,42,0.9290322580645162,0.47619047619047616
gp_20_09_20_2023,290,297333,265,25,249516,47817,253,25,0,12,265,37,0.9547169811320755,0.6756756756756757
gp_20_10_02_2023,382,402428,341,41,319477,82951,300,37,4,40,344,81,0.872093023255814,0.4567901234567901
gp_21_06_24_2023,248,248831,136,112,110941,137890,115,111,1,25,141,137,0.8156028368794326,0.8102189781021898
gp_21_07_07_2023,655,691177,290,365,272931,418246,269,355,17,41,327,413,0.8226299694189603,0.8595641646489104
gp_22_06_24_2023,71,73857,37,34,28386,45471,33,34,0,7,40,41,0.825,0.8292682926829268
gp_22_07_07_2023,486,500468,186,300,165144,335324,164,297,2,49,215,348,0.7627906976744186,0.853448275862069
gp_24_06_24_2023,100,101074,50,50,40641,60433,38,50,0,15,53,65,0.7169811320754716,0.7692307692307693
gp_24_07_07_2023,486,500468,201,285,165144,335324,184,280,7,50,241,337,0.7634854771784232,0.8308605341246291
tf_1017_07_07_2023,531,582720,356,175,387331,195389,348,143,32,8,388,183,0.8969072164948454,0.7814207650273224
tf_1017_07_23_2023,626,671138,394,232,516855,154283,387,105,129,7,523,241,0.739961759082218,0.43568464730290457
tf_1017_08_10_2023,308,324330,229,79,287792,36538,228,20,60,1,289,81,0.7889273356401384,0.24691358024691357
tf_1017_08_24_2023,328,344701,317,11,315314,29387,313,8,3,4,320,15,0.978125,0.5333333333333333
tf_1026_06_25_2023,407,445394,251,156,263192,182202,246,146,10,5,261,161,0.9425287356321839,0.906832298136646
tf_1026_07_07_2023,281,287780,241,40,242895,44885,235,29,11,6,252,46,0.9325396825396826,0.6304347826086957
tf_1026_07_23_2023,658,701287,502,156,543003,158284,495,120,36,7,538,163,0.9200743494423792,0.7361963190184049
tf_1026_08_10_2023,307,319695,250,57,252686,67009,228,31,26,22,276,79,0.8260869565217391,0.3924050632911392
tf_1026_08_24_2023,305,315280,248,57,278034,37246,243,24,33,5,281,62,0.8647686832740213,0.3870967741935484
tf_1033_06_25_2023,178,190280,129,49,146491,43789,126,34,15,3,144,52,0.875,0.6538461538461539
tf_1033_07_07_2023,351,373352,300,51,314931,58421,295,32,19,5,319,56,0.9247648902821317,0.5714285714285714
tf_1033_07_23_2023,240,251556,182,58,215646,35910,180,30,28,2,210,60,0.8571428571428571,0.5
tf_1033_08_10_2023,213,230962,165,48,169520,61442,146,24,24,19,189,67,0.7724867724867724,0.3582089552238806
tf_1033_08_24_2023,293,305031,197,96,235677,69354,188,38,58,9,255,105,0.7372549019607844,0.3619047619047619
tf_1042_06_25_2023,307,335517,225,82,238221,97296,222,74,8,3,233,85,0.9527896995708155,0.8705882352941177
tf_1042_07_07_2023,277,289608,234,43,235185,54423,229,39,4,5,238,48,0.9621848739495799,0.8125
tf_1042_07_23_2023,206,216535,174,32,179730,36805,174,23,9,0,183,32,0.9508196721311475,0.71875
tf_1042_08_10_2023,243,259037,191,52,181827,77210,163,38,14,28,205,80,0.7951219512195122,0.475
tf_1042_08_24_2023,326,342597,256,70,269073,73524,246,37,33,10,289,80,0.8512110726643599,0.4625
tf_1051_06_25_2023,246,259270,195,51,194718,64552,192,43,8,3,203,54,0.9458128078817734,0.7962962962962963
tf_1051_07_07_2023,311,322636,268,43,268838,53798,262,36,7,6,275,49,0.9527272727272728,0.7346938775510204
tf_1051_07_23_2023,228,236158,177,51,204880,31278,175,17,34,2,211,53,0.8293838862559242,0.32075471698113206
tf_1051_08_10_2023,251,261878,178,73,198809,63069,152,46,27,27,206,100,0.7378640776699029,0.46
tf_1051_08_24_2023,246,255330,198,48,203379,51951,178,23,25,20,223,68,0.7982062780269058,0.3382352941176471
tf_1064_06_25_2023,216,241532,160,56,161799,79733,156,48,8,4,168,60,0.9285714285714286,0.8
tf_1064_07_07_2023,226,243227,199,27,197197,46030,187,22,5,12,204,39,0.9166666666666666,0.5641025641025641
tf_1064_07_23_2023,190,204335,152,38,167778,36557,151,24,14,1,166,39,0.9096385542168675,0.6153846153846154
tf_1064_08_10_2023,222,238047,158,64,180178,57869,151,33,32,7,190,72,0.7947368421052632,0.4583333333333333
tf_1064_08_24_2023,339,355269,263,76,284694,70575,246,35,41,18,305,94,0.8065573770491803,0.3723404255319149
tf_1075_06_25_2023,193,195481,138,55,137368,58113,132,51,4,6,142,61,0.9295774647887324,0.8360655737704918
tf_1075_07_07_2023,236,252184,189,47,197382,54802,179,35,12,10,201,57,0.8905472636815921,0.6140350877192983
tf_1075_07_23_2023,268,273058,185,83,213056,60002,182,37,46,3,231,86,0.7878787878787878,0.43023255813953487
tf_1075_08_10_2023,223,231035,160,63,180764,50271,150,22,41,10,201,73,0.746268656716418,0.3013698630136986
tf_1075_08_24_2023,317,341034,273,44,283844,57190,255,28,16,18,289,62,0.8823529411764706,0.45161290322580644
tf_2016_06_25_2023,282,288456,221,61,226100,62356,214,58,3,7,224,68,0.9553571428571429,0.8529411764705882
tf_2016_07_07_2023,259,262931,223,36,223896,39035,215,26,10,8,233,44,0.9227467811158798,0.5909090909090909
tf_2016_07_23_2023,254,263847,222,32,224765,39082,211,21,11,11,233,43,0.9055793991416309,0.4883720930232558
tf_2016_08_10_2023,246,255572,193,53,222539,33033,188,25,28,5,221,58,0.8506787330316742,0.43103448275862066
tf_2016_08_24_2023,338,361536,276,62,311373,50163,262,22,40,14,316,76,0.8291139240506329,0.2894736842105263
tf_2027_07_07_2023,224,244519,161,63,181263,63256,158,57,6,3,167,66,0.9461077844311377,0.8636363636363636
tf_2027_07_23_2023,190,198592,135,55,152385,46207,134,29,26,1,161,56,0.8322981366459627,0.5178571428571429
tf_2027_08_10_2023,180,189783,132,48,149063,40720,123,22,26,9,158,57,0.7784810126582279,0.38596491228070173
tf_2027_08_24_2023,283,304482,192,91,256324,48158,176,25,66,17,259,108,0.6795366795366795,0.23148148148148148
tf_2035_06_25_2023,212,214254,173,39,167714,46540,169,34,5,4,178,43,0.949438202247191,0.7906976744186046
tf_2035_07_07_2023,275,281361,237,38,242809,38552,229,29,9,8,246,46,0.9308943089430894,0.6304347826086957
tf_2035_07_23_2023,245,252566,206,39,213114,39452,195,26,13,11,219,50,0.8904109589041096,0.52
tf_2035_08_10_2023,216,222618,174,42,180334,42284,162,31,11,12,185,54,0.8756756756756757,0.5740740740740741
tf_2035_08_24_2023,319,334930,249,70,284962,49968,235,26,44,14,293,84,0.8020477815699659,0.30952380952380953
tf_2043_06_25_2023,234,242259,181,53,182666,59593,176,44,9,5,190,58,0.9263157894736842,0.7586206896551724
tf_2043_07_07_2023,246,253772,208,38,212978,40794,203,30,8,5,216,43,0.9398148148148148,0.6976744186046512
tf_2043_07_23_2023,247,255769,199,48,215719,40050,194,35,13,5,212,53,0.9150943396226415,0.660377358490566
tf_2043_08_10_2023,216,220117,169,47,179663,40454,158,24,23,11,192,58,0.8229166666666666,0.41379310344827586
tf_2043_08_24_2023,187,237930,150,37,158047,79883,138,16,22,12,172,50,0.8023255813953488,0.32
tf_2051_06_25_2023,237,251308,181,56,188985,62323,175,45,12,6,193,63,0.9067357512953368,0.7142857142857143
tf_2051_07_07_2023,263,269854,230,33,228540,41314,222,27,6,8,236,41,0.940677966101695,0.6585365853658537
tf_2051_07_23_2023,289,295612,234,55,251105,44507,225,37,18,9,252,64,0.8928571428571429,0.578125
tf_2051_08_10_2023,281,290786,248,33,239289,51497,239,27,6,10,255,43,0.9372549019607843,0.627906976744186
tf_2051_08_24_2023,328,341607,246,82,274525,67082,226,32,50,20,296,102,0.7635135135135135,0.3137254901960784
tf_2062_06_25_2023,249,260004,202,47,167460,92544,167,41,6,35,208,82,0.8028846153846154,0.5
tf_2062_07_07_2023,230,236873,197,33,198319,38554,187,23,10,10,207,43,0.9033816425120773,0.5348837209302325
tf_2062_07_23_2023,325,332246,263,62,282585,49661,252,39,23,12,287,74,0.8780487804878049,0.527027027027027
tf_2062_08_10_2023,222,234680,168,54,194145,40535,160,25,29,8,197,62,0.8121827411167513,0.4032258064516129
tf_2062_08_24_2023,299,316828,213,86,258960,57868,201,30,56,12,269,98,0.7472118959107806,0.30612244897959184
tf_2074_06_25_2023,180,190561,134,46,84298,106263,85,42,4,49,138,95,0.6159420289855072,0.4421052631578947
tf_2074_07_07_2023,298,308488,265,33,253448,55040,254,25,8,14,276,47,0.9202898550724637,0.5319148936170213
tf_2074_07_23_2023,253,263008,203,50,212978,50030,189,36,14,14,217,64,0.8709677419354839,0.5625
tf_2074_08_10_2023,288,301854,212,76,242904,58950,196,31,45,16,257,92,0.7626459143968871,0.33695652173913043
tf_2074_08_24_2023,308,327134,235,73,277535,49599,224,30,43,11,278,84,0.8057553956834532,0.35714285714285715
tf_10171_06_25_2023,248,288869,93,155,96733,192136,83,151,5,12,100,168,0.83,0.8988095238095238
tf_10172_06_25_2023,297,319745,164,133,142648,177097,144,130,4,22,170,156,0.8470588235294118,0.8333333333333334
tf_10173_06_25_2023,439,513311,151,288,167572,345739,138,259,30,17,185,306,0.745945945945946,0.8464052287581699
tf_20271_06_25_2023,389,433033,167,222,188262,244771,144,198,24,26,194,248,0.7422680412371134,0.7983870967741935
tf_20272_06_25_2023,402,420971,146,256,152390,268581,142,237,20,6,168,263,0.8452380952380952,0.9011406844106464
tf_20273_06_25_2023,249,273765,95,154,121401,152364,79,119,40,20,139,179,0.5683453237410072,0.664804469273743
gp_02_06_24_2023,477,542220,285,192,267818,274402,255,181,12,30,297,223,0.8585858585858586,0.8116591928251121
gp_03_06_24_2023,640,789162,421,219,416071,373091,386,211,8,43,437,262,0.8832951945080092,0.8053435114503816
gp_03_08_02_2023,289,316165,179,110,174814,141351,167,106,4,13,184,123,0.907608695652174,0.8617886178861789
gp_03_08_12_2023,381,421492,288,93,286952,134540,274,84,9,14,297,107,0.9225589225589226,0.7850467289719626
gp_03_08_25_2023,281,298847,210,71,207425,91422,206,70,1,4,211,75,0.976303317535545,0.9333333333333333
gp_03_09_07_2023,259,268303,229,30,220267,48036,214,27,3,15,232,45,0.9224137931034483,0.6
gp_03_09_20_2023,278,286558,234,44,232083,54475,215,39,5,19,239,63,0.899581589958159,0.6190476190476191
gp_03_10_04_2023,275,288609,214,61,212550,76059,200,53,8,14,222,75,0.9009009009009009,0.7066666666666667
gp_04_06_24_2023,591,753216,405,186,369059,384157,373,177,9,36,418,222,0.8923444976076556,0.7972972972972973
gp_04_08_02_2023,194,214137,135,59,138477,75660,131,50,9,5,145,64,0.903448275862069,0.78125
gp_04_08_12_2023,183,191088,157,26,152930,38158,140,22,4,17,161,43,0.8695652173913043,0.5116279069767442
gp_04_08_25_2023,180,189196,153,27,147984,41212,143,19,9,10,162,38,0.8827160493827161,0.5
gp_04_09_07_2023,240,251119,196,44,192039,59080,177,36,8,19,204,63,0.8676470588235294,0.5714285714285714
gp_04_09_20_2023,252,275256,218,34,198898,76358,199,34,0,20,219,54,0.908675799086758,0.6296296296296297
gp_04_10_04_2023,233,262017,203,30,196205,65812,180,26,4,23,207,53,0.8695652173913043,0.49056603773584906
gp_05_06_24_2023,375,537373,266,109,251776,285597,242,99,11,25,278,135,0.8705035971223022,0.7333333333333333
gp_05_08_02_2023,298,318231,172,126,162790,155441,152,123,3,20,175,146,0.8685714285714285,0.8424657534246576
gp_05_08_12_2023,208,219548,159,49,166899,52649,158,40,9,1,168,50,0.9404761904761905,0.8
gp_05_08_25_2023,232,244895,202,30,200363,44532,187,24,6,15,208,45,0.8990384615384616,0.5333333333333333
gp_05_09_01_2023,273,280999,241,32,235620,45379,228,23,9,13,250,45,0.912,0.5111111111111111
gp_06_06_24_2023,448,508809,275,173,260927,247882,257,170,3,23,283,196,0.9081272084805654,0.8673469387755102
gp_06_08_02_2023,181,190700,157,24,151695,39005,152,24,0,5,157,29,0.9681528662420382,0.8275862068965517
gp_06_08_12_2023,263,275032,212,51,210924,64108,201,49,2,13,216,64,0.9305555555555556,0.765625
gp_06_08_25_2023,225,242976,208,17,198660,44316,193,14,3,15,211,32,0.9146919431279621,0.4375
gp_06_09_01_2023,207,220618,184,23,184212,36406,167,20,3,18,188,41,0.8882978723404256,0.4878048780487805
gp_07_06_24_2023,434,550083,339,95,312057,238026,317,90,5,23,345,118,0.9188405797101449,0.7627118644067796
gp_07_08_02_2023,231,240502,158,73,151158,89344,152,73,0,7,159,80,0.9559748427672956,0.9125
gp_08_06_24_2023,381,457801,248,133,229638,228163,216,127,7,33,256,167,0.84375,0.7604790419161677
gp_08_08_02_2023,149,151133,128,21,128418,22715,126,20,1,2,129,23,0.9767441860465116,0.8695652173913043
gp_09_06_24_2023,328,439158,196,132,180106,259052,185,127,5,13,203,145,0.9113300492610837,0.8758620689655172
pw_12B4_07_06_2023,280,293253,262,18,251124,42129,255,18,0,7,262,25,0.9732824427480916,0.72
pw_12B4_07_24_2023,296,302945,277,19,270433,32512,272,17,2,5,279,24,0.974910394265233,0.7083333333333334
pw_12B4_08_11_2023,362,363649,319,43,343346,20303,311,12,31,8,350,51,0.8885714285714286,0.23529411764705882
pw_12B41_06_25_2023,234,247818,186,48,171881,75937,178,43,5,8,191,56,0.9319371727748691,0.7678571428571429
pw_12B42_06_25_2023,262,298370,228,34,205044,93326,206,31,3,22,231,56,0.8917748917748918,0.5535714285714286
pw_12B43_06_25_2023,269,296172,227,42,215246,80926,209,38,4,18,231,60,0.9047619047619048,0.6333333333333333
sw_22A29_06_25_2023,187,214531,155,32,153719,60812,148,30,2,7,157,39,0.9426751592356688,0.7692307692307693
sw_28A1_06_25_2023,186,207214,149,37,133407,73807,133,36,1,16,150,53,0.8866666666666667,0.6792452830188679
sw_49B29_06_25_2023,457,475177,280,177,239291,235886,262,176,2,18,282,196,0.9290780141843972,0.8979591836734694
sw_50B1_06_25_2023,524,544816,301,223,262213,282603,276,222,1,26,303,249,0.9108910891089109,0.891566265060241
pw_24C4_07_06_2023,304,319363,271,33,254667,64696,260,30,3,11,274,44,0.948905109489051,0.6818181818181818
pw_24C4_07_24_2023,314,323306,284,30,279445,43861,278,28,2,6,286,36,0.972027972027972,0.7777777777777778
pw_24C4_08_11_2023,313,315635,275,38,293433,22202,269,17,21,6,296,44,0.9087837837837838,0.38636363636363635
pw_24C41_06_25_2023,257,287168,218,39,193272,93896,194,38,1,24,219,63,0.8858447488584474,0.6031746031746031
pw_24C42_06_25_2023,219,232390,184,35,164329,68061,164,31,4,20,188,55,0.8723404255319149,0.5636363636363636
pw_24C43_06_25_2023,233,244588,206,27,177011,67577,178,23,4,29,211,56,0.8436018957345972,0.4107142857142857
sw_72C29_06_25_2023,420,453377,238,182,203142,250235,209,179,3,29,241,211,0.8672199170124482,0.8483412322274881
sw_82C1_06_25_2023,223,239650,91,132,76299,163351,83,132,0,8,91,140,0.9120879120879121,0.9428571428571428
sw_22A29_07_06_2023,190,196582,177,13,172792,23790,170,13,0,7,177,20,0.96045197740113,0.65
sw_28A1_07_06_2023,596,478031,290,306,297711,180320,286,152,1,4,291,157,0.9828178694158075,0.9681528662420382
pw_35A4_07_06_2023,343,368374,295,48,288733,79641,274,47,1,21,296,69,0.9256756756756757,0.6811594202898551
pw_35A4_07_24_2023,362,373830,334,28,323060,50770,318,28,0,16,334,44,0.9520958083832335,0.6363636363636364
pw_35A4_08_11_2023,279,279395,269,10,265464,13931,258,5,5,11,274,21,0.9416058394160584,0.23809523809523808
pw_35A41_06_25_2023,230,249529,194,36,176468,73061,174,35,1,20,195,56,0.8923076923076924,0.625
pw_35A42_06_25_2023,254,268743,225,29,204961,63782,210,27,2,15,227,44,0.9251101321585903,0.6136363636363636
pw_35A43_06_25_2023,245,256238,214,31,200970,55268,195,31,0,18,213,49,0.9154929577464789,0.6326530612244898
sw_49B29_07_06_2023,302,312838,278,24,271368,41470,265,23,1,13,279,37,0.9498207885304659,0.6216216216216216
sw_50B1_07_06_2023,172,180095,146,26,140715,39380,137,26,0,9,146,35,0.9383561643835616,0.7428571428571429
sw_72C29_07_06_2023,261,279807,219,42,221395,58412,203,39,3,16,222,58,0.9144144144144144,0.6724137931034483
sw_82C1_07_06_2023,248,260699,208,40,200796,59903,196,40,0,12,208,52,0.9423076923076923,0.7692307692307693
sw_22A29_07_24_2023,836,868512,736,100,724749,143763,716,93,7,20,743,120,0.9636608344549125,0.775
sw_28A1_07_24_2023,431,464396,364,67,331345,133051,355,65,2,9,366,76,0.9699453551912568,0.8552631578947368
sw_49B29_07_24_2023,639,678833,399,240,398390,280443,378,237,3,21,402,261,0.9402985074626866,0.9080459770114943
sw_50B1_07_24_2023,750,806958,592,158,570127,236831,574,151,7,18,599,176,0.9582637729549248,0.8579545454545454
sw_72C29_07_24_2023,619,652216,444,175,448601,203615,426,172,3,19,448,194,0.9508928571428571,0.8865979381443299
sw_82C1_07_24_2023,879,922314,728,151,701837,220477,698,147,4,30,732,181,0.953551912568306,0.8121546961325967
sw_22A29_08_11_2023,260,264405,246,14,249226,15179,237,0,14,9,260,23,0.9115384615384615,0.0
sw_28A1_08_11_2023,234,236176,228,6,223044,13132,219,3,3,9,231,15,0.948051948051948,0.2
sw_49B29_08_11_2023,273,276883,227,46,252851,24032,204,6,40,23,267,69,0.7640449438202247,0.08695652173913043
sw_50B1_08_11_2023,222,227914,217,5,210462,17452,210,1,4,7,221,12,0.9502262443438914,0.08333333333333333
sw_72C29_08_11_2023,280,283793,247,33,266771,17022,231,0,33,16,280,49,0.825,0.0
sw_82C1_08_11_2023,198,206115,189,9,169577,36538,169,4,5,21,195,30,0.8666666666666667,0.13333333333333333
ta_Big_Beef_Day_Zero,542,762973,297,245,161046,601927,212,244,0,174,386,418,0.5492227979274611,0.583732057416268
ta_German_Johnson_Day_Zero,242,311514,152,90,78453,233061,97,87,5,105,207,197,0.46859903381642515,0.4416243654822335
ta_Mambo_Day_Zero,431,654985,171,260,115431,539554,138,260,1,78,217,339,0.6359447004608295,0.7669616519174042
pv_R1C4_07_04_2023,529,580263,303,226,306563,273700,298,220,6,5,309,231,0.9644012944983819,0.9523809523809523
pv_R1C4_07_21_2023,184,196213,149,35,152503,43710,142,28,7,7,156,42,0.9102564102564102,0.6666666666666666
pv_R1C4_08_12_2023,288,299477,249,39,233813,65664,234,34,5,15,254,54,0.9212598425196851,0.6296296296296297
pv_R1C4_08_26_2023,232,242536,207,25,190748,51788,195,25,0,12,207,37,0.9420289855072463,0.6756756756756757
pv_R1C4_09_08_2023,251,273280,236,15,216526,56754,210,12,3,26,239,41,0.8786610878661087,0.2926829268292683
pv_R1C4_09_21_2023,259,276467,238,21,225511,50956,223,15,6,15,244,36,0.9139344262295082,0.4166666666666667
pv_R1C4_10_05_2023,380,402513,350,30,322361,80152,313,22,8,37,358,67,0.8743016759776536,0.3283582089552239
pv_R1C4_10_20_2023,233,245513,217,16,201946,43567,200,15,1,17,218,33,0.9174311926605505,0.45454545454545453
pv_R1C41_06_22_2023,198,207409,165,33,155315,52094,161,31,2,5,168,38,0.9583333333333334,0.8157894736842105
pv_R1C42_06_22_2023,348,361737,268,80,260270,101467,261,80,0,8,269,88,0.9702602230483272,0.9090909090909091
pv_R1C43_06_22_2023,334,362290,248,86,246553,115737,241,83,3,9,253,95,0.9525691699604744,0.8736842105263158
pv_R1C44_06_22_2023,521,562914,415,106,401114,161800,403,106,1,16,420,123,0.9595238095238096,0.8617886178861789
pv_R1C45_06_22_2023,524,549274,398,126,408717,140557,387,124,2,14,403,140,0.9602977667493796,0.8857142857142857
pv_R1C7_07_04_2023,218,225557,181,37,165196,60361,170,37,0,11,181,48,0.9392265193370166,0.7708333333333334
pv_R1C7_07_21_2023,261,275869,225,36,211189,64680,213,34,2,12,227,48,0.9383259911894273,0.7083333333333334
pv_R1C7_08_12_2023,270,296206,232,38,220192,76014,220,36,2,12,234,50,0.9401709401709402,0.72
pv_R1C7_08_26_2023,301,327828,271,30,245715,82113,259,29,1,12,272,42,0.9522058823529411,0.6904761904761905
pv_R1C7_09_08_2023,210,244025,193,17,181473,62552,185,16,1,8,194,25,0.9536082474226805,0.64
pv_R1C7_09_21_2023,370,406557,335,35,320007,86550,314,32,3,21,338,56,0.9289940828402367,0.5714285714285714
pv_R1C7_10_05_2023,358,395899,328,30,320651,75248,310,28,2,18,330,48,0.9393939393939394,0.5833333333333334
pv_R1C7_10_20_2023,292,314655,263,29,253697,60958,254,27,2,11,267,40,0.951310861423221,0.675
pv_R1C71_06_22_2023,516,559191,448,68,426702,132489,425,67,1,26,452,94,0.9402654867256637,0.7127659574468085
pv_R1C72_06_22_2023,265,278916,224,41,215252,63664,215,40,1,9,225,50,0.9555555555555556,0.8
pv_R1C73_06_22_2023,539,560053,437,102,430938,129115,419,99,3,19,441,121,0.9501133786848073,0.8181818181818182
pv_R1C74_06_22_2023,629,667003,440,189,432152,234851,423,187,2,18,443,207,0.9548532731376975,0.9033816425120773
pv_R1C75_06_22_2023,494,525553,380,114,364218,161335,355,113,2,25,382,140,0.9293193717277487,0.8071428571428572
pv_R2C4_07_04_2023,218,225335,188,30,173803,51532,176,27,3,12,191,42,0.9214659685863874,0.6428571428571429
pv_R2C4_07_21_2023,285,297509,235,50,231868,65641,220,38,12,15,247,65,0.8906882591093117,0.5846153846153846
pv_R2C4_08_12_2023,291,314262,230,61,235350,78912,216,54,7,14,237,75,0.9113924050632911,0.72
pv_R2C4_08_26_2023,341,358480,296,45,279497,78983,270,39,6,27,303,72,0.8910891089108911,0.5416666666666666
pv_R2C4_09_08_2023,254,269982,232,22,221878,48104,218,17,5,14,237,36,0.919831223628692,0.4722222222222222
pv_R2C4_09_21_2023,298,317125,266,32,255044,62081,244,31,1,22,267,54,0.9138576779026217,0.5740740740740741
pv_R2C4_10_05_2023,279,296184,263,16,238879,57305,236,15,1,27,264,43,0.8939393939393939,0.3488372093023256
pv_R2C4_10_20_2023,347,366181,317,30,290675,75506,290,27,3,27,320,57,0.90625,0.47368421052631576
pv_R2C41_06_22_2023,335,377509,249,86,250246,127263,241,86,0,8,249,94,0.9678714859437751,0.9148936170212766
pv_R2C42_06_22_2023,566,599614,432,134,451755,147859,420,129,5,13,438,147,0.958904109589041,0.8775510204081632
pv_R2C43_06_22_2023,518,555958,392,126,408208,147750,386,125,1,6,393,132,0.9821882951653944,0.946969696969697
pv_R2C44_06_22_2023,340,363912,276,64,262666,101246,273,64,0,4,277,68,0.9855595667870036,0.9411764705882353
pv_R2C45_06_22_2023,528,558630,401,127,398182,160448,390,122,5,11,406,138,0.9605911330049262,0.8840579710144928
pv_R2C7_07_04_2023,236,243147,203,33,195530,47617,195,31,2,8,205,41,0.9512195121951219,0.7560975609756098
pv_R2C7_07_21_2023,225,238957,199,26,188268,50689,190,26,0,9,199,35,0.9547738693467337,0.7428571428571429
pv_R2C7_08_12_2023,221,236671,203,18,179400,57271,182,18,0,21,203,39,0.896551724137931,0.46153846153846156
pv_R2C7_08_26_2023,247,266128,231,16,212903,53225,211,13,3,20,234,36,0.9017094017094017,0.3611111111111111
pv_R2C7_09_08_2023,258,283667,239,19,226294,57373,228,19,0,11,239,30,0.9539748953974896,0.6333333333333333
pv_R2C7_09_21_2023,282,309838,266,16,249193,60645,250,16,0,17,267,33,0.9363295880149812,0.48484848484848486
pv_R2C7_10_05_2023,262,284481,237,25,228117,56364,225,21,4,12,241,37,0.9336099585062241,0.5675675675675675
pv_R2C7_10_20_2023,237,253320,217,20,201590,51730,207,19,1,10,218,30,0.9495412844036697,0.6333333333333333
pv_R2C71_06_22_2023,487,543342,398,89,391554,151788,371,88,2,27,400,117,0.9275,0.7521367521367521
pv_R2C72_06_22_2023,625,648716,460,165,488389,160327,447,163,2,15,464,180,0.9633620689655172,0.9055555555555556
pv_R2C73_06_22_2023,501,513494,419,82,408065,105429,404,81,1,17,422,99,0.957345971563981,0.8181818181818182
pv_R2C74_06_22_2023,473,521406,386,87,382216,139190,374,87,0,13,387,100,0.9664082687338501,0.87
pv_R2C75_06_22_2023,499,510906,407,92,405092,105814,390,81,11,18,419,110,0.9307875894988067,0.7363636363636363
pv_R3C4_07_04_2023,256,262845,224,32,210205,52640,208,25,7,16,231,48,0.9004329004329005,0.5208333333333334
pv_R3C4_07_21_2023,323,339536,274,49,265281,74255,259,39,10,15,284,64,0.9119718309859155,0.609375
pv_R3C4_08_12_2023,266,286880,215,51,211409,75471,203,42,9,13,225,64,0.9022222222222223,0.65625
pv_R3C4_08_26_2023,284,300588,248,36,235980,64608,233,33,3,15,251,51,0.9282868525896414,0.6470588235294118
pv_R3C4_09_08_2023,343,369500,302,41,285540,83960,280,33,8,22,310,63,0.9032258064516129,0.5238095238095238
pv_R3C4_09_21_2023,346,378372,313,33,288917,89455,294,29,4,19,317,52,0.9274447949526814,0.5576923076923077
pv_R3C4_10_05_2023,372,392568,334,38,298661,93907,299,31,7,35,341,73,0.8768328445747801,0.4246575342465753
pv_R3C4_10_20_2023,292,316633,233,59,228244,88389,213,50,9,20,242,79,0.8801652892561983,0.6329113924050633
pv_R3C41_06_22_2023,318,371325,268,50,264798,106527,252,47,3,19,274,69,0.9197080291970803,0.6811594202898551
pv_R3C42_06_22_2023,412,430923,334,78,342367,88556,327,77,1,8,336,86,0.9732142857142857,0.8953488372093024
pv_R3C43_06_22_2023,467,495026,375,92,380396,114630,365,90,2,11,378,103,0.9656084656084656,0.8737864077669902
pv_R3C44_06_22_2023,368,409654,299,69,298750,110904,291,68,1,8,300,77,0.97,0.8831168831168831
pv_R3C45_06_22_2023,368,393916,327,41,309471,84445,312,39,2,15,329,56,0.9483282674772037,0.6964285714285714
pv_R3C7_07_04_2023,185,199740,156,29,160702,39038,150,27,2,6,158,35,0.9493670886075949,0.7714285714285715
pv_R3C7_07_21_2023,183,204997,176,7,164646,40351,165,7,0,10,175,17,0.9428571428571428,0.4117647058823529
pv_R3C7_08_12_2023,214,226068,167,47,166211,59857,155,46,1,12,168,59,0.9226190476190477,0.7796610169491526
pv_R3C7_08_26_2023,333,350281,295,38,267828,82453,271,38,0,25,296,63,0.9155405405405406,0.6031746031746031
pv_R3C7_09_08_2023,204,227321,179,25,166289,61032,162,25,0,16,178,41,0.9101123595505618,0.6097560975609756
pv_R3C7_09_21_2023,219,249207,208,11,188060,61147,198,10,1,10,209,21,0.9473684210526315,0.47619047619047616
pv_R3C7_10_05_2023,319,347701,283,36,273658,74043,263,35,1,20,284,56,0.926056338028169,0.625
pv_R3C7_10_20_2023,267,288400,239,28,222332,66068,211,26,2,29,242,57,0.871900826446281,0.45614035087719296
pv_R3C71_06_22_2023,396,447425,338,58,337183,110242,327,55,3,13,343,71,0.9533527696793003,0.7746478873239436
pv_R3C72_06_22_2023,412,447782,313,99,340777,107005,302,96,3,13,318,112,0.949685534591195,0.8571428571428571
pv_R3C73_06_22_2023,405,442021,332,73,332421,109600,322,70,3,11,336,84,0.9583333333333334,0.8333333333333334
pv_R3C74_06_22_2023,412,531957,339,73,346613,185344,322,70,3,17,342,90,0.9415204678362573,0.7777777777777778
pv_R3C75_06_22_2023,430,440619,336,94,350242,90377,328,84,10,8,346,102,0.9479768786127167,0.8235294117647058
pv_R4C4_07_04_2023,251,253711,224,27,208746,44965,209,27,0,15,224,42,0.9330357142857143,0.6428571428571429
pv_R4C4_07_21_2023,307,320768,257,50,245113,75655,229,42,8,28,265,78,0.8641509433962264,0.5384615384615384
pv_R4C4_08_12_2023,313,332564,253,60,250779,81785,227,54,6,26,259,86,0.8764478764478765,0.627906976744186
pv_R4C4_08_26_2023,306,321874,260,46,244311,77563,249,45,1,11,261,57,0.9540229885057471,0.7894736842105263
pv_R4C4_09_08_2023,212,239415,186,26,173515,65900,173,25,1,13,187,39,0.9251336898395722,0.6410256410256411
pv_R4C4_09_21_2023,338,375510,310,28,282989,92521,288,28,0,22,310,50,0.9290322580645162,0.56
pv_R4C4_10_05_2023,340,368614,303,37,278581,90033,278,36,1,25,304,62,0.9144736842105263,0.5806451612903226
pv_R4C4_10_20_2023,299,331291,267,32,234700,96591,227,31,1,41,269,73,0.8438661710037175,0.4246575342465753
pv_R4C41_06_22_2023,359,423895,300,59,295095,128800,285,57,2,16,303,75,0.9405940594059405,0.76
pv_R4C42_06_22_2023,323,354150,260,63,270340,83810,253,62,2,10,265,74,0.9547169811320755,0.8378378378378378
pv_R4C43_06_22_2023,406,425000,333,73,327031,97969,326,67,7,11,344,85,0.9476744186046512,0.788235294117647
pv_R4C44_06_22_2023,418,473619,296,122,310609,163010,289,121,1,9,299,131,0.9665551839464883,0.9236641221374046
pv_R4C45_06_22_2023,576,588072,418,158,392006,196066,414,157,0,4,418,161,0.9904306220095693,0.9751552795031055
pv_R4C7_07_04_2023,284,287465,251,33,243686,43779,243,31,2,8,253,41,0.9604743083003953,0.7560975609756098
pv_R4C7_07_21_2023,209,223532,188,21,168801,54731,169,20,1,19,189,40,0.8941798941798942,0.5
pv_R4C7_08_12_2023,216,224449,181,35,171696,52753,168,35,0,13,181,48,0.9281767955801105,0.7291666666666666
pv_R4C7_08_26_2023,359,367705,318,41,304298,63407,302,37,4,17,323,58,0.934984520123839,0.6379310344827587
pv_R4C7_09_08_2023,318,329953,284,34,276404,53549,267,29,5,18,290,52,0.9206896551724137,0.5576923076923077
pv_R4C7_09_21_2023,337,355970,304,33,293216,62754,287,31,2,17,306,50,0.9379084967320261,0.62
pv_R4C7_10_05_2023,305,317442,280,25,268523,48919,264,24,1,16,281,41,0.9395017793594306,0.5853658536585366
pv_R4C7_10_20_2023,295,303962,257,38,238543,65419,231,35,3,26,260,64,0.8884615384615384,0.546875
pv_R4C71_06_22_2023,328,377659,258,70,266961,110698,254,68,2,7,263,77,0.9657794676806084,0.8831168831168831
pv_R4C72_06_22_2023,450,471124,355,95,358812,112312,335,87,8,20,363,115,0.9228650137741047,0.7565217391304347
pv_R4C73_06_22_2023,464,487219,352,112,354301,132918,337,109,3,16,356,128,0.9466292134831461,0.8515625
pv_R4C74_06_22_2023,396,444794,299,97,307287,137507,287,93,4,13,304,110,0.944078947368421,0.8454545454545455
pv_R4C75_06_22_2023,413,438983,339,74,330156,108827,310,70,4,32,346,106,0.8959537572254336,0.660377358490566
ta_Red_Deuce_Day_Zero,246,282726,163,83,96556,186170,123,83,1,80,204,164,0.6029411764705882,0.5060975609756098
ta_Sugar_Baby_Day_Zero,243,315826,80,163,59707,256119,52,160,6,41,99,207,0.5252525252525253,0.7729468599033816
